Aria | Composer | Opera | Voice | Filename
----------------------------------------------------------------------------------------------------
L'implacabile Dea | Gluck, Christoph Willibald von | Alceste | Check (Ercole) | L'implacabile Dea.pdf
C'est envain | Gluck, Christoph Willibald von | Alceste | Check (Hercule) | C'est envain.pdf
La Dea d'Averno avvolta | Gluck, Christoph Willibald von | Alceste | Check (Il Sommo Sacerdote) | La Dea d'Averno avvolta.pdf
Déjà la mort s'apprête | Gluck, Christoph Willibald von | Alceste | Check (Le Grand-Prêtre) | Déjà la mort s'apprête.pdf
Se grave è a te | Gluck, Christoph Willibald von | Alceste | Check (Tanato) | Se grave è a te.pdf
Caron t'appelle, entends sa voix! | Gluck, Christoph Willibald von | Alceste | Check (Un Dieu Infernal) | Caron t'appelle, entends sa voix!.pdf
A vostri lai | Gluck, Christoph Willibald von | Alceste | Soprano/女高音 | A vostri lai.pdf
Ah! Divinités implacables | Gluck, Christoph Willibald von | Alceste | Soprano/女高音 | Ah! Divinités implacables.pdf
Divinités du Styx | Gluck, Christoph Willibald von | Alceste | Soprano/女高音 | Divinités du Styx.pdf
Eh! Pourrai je vivre sans toi | Gluck, Christoph Willibald von | Alceste | Soprano/女高音 | Eh! Pourrai je vivre sans toi.pdf
Fatal divinità | Gluck, Christoph Willibald von | Alceste | Soprano/女高音 | Fatal divinità.pdf
Grand Dieux, du destin, qui m'accable | Gluck, Christoph Willibald von | Alceste | Soprano/女高音 | Grand Dieux, du destin, qui m'accable.pdf
Je n'ai jamais chéri la vie | Gluck, Christoph Willibald von | Alceste | Soprano/女高音 | Je n'ai jamais chéri la vie.pdf
Mi arridea sin or la vita | Gluck, Christoph Willibald von | Alceste | Soprano/女高音 | Mi arridea sin or la vita.pdf
O Dei, del mio fato tiranno | Gluck, Christoph Willibald von | Alceste | Soprano/女高音 | O Dei, del mio fato tiranno.pdf
O funesta Dea | Gluck, Christoph Willibald von | Alceste | Soprano/女高音 | O funesta Dea.pdf
Senza del tuo sospir | Gluck, Christoph Willibald von | Alceste | Soprano/女高音 | Senza del tuo sospir.pdf
Alceste, au nom des Dieux | Gluck, Christoph Willibald von | Alceste | Check (Admète) | Alceste, au nom des Dieux.pdf
Bannis la crainte et les alarmes | Gluck, Christoph Willibald von | Alceste | Check (Admète) | Bannis la crainte et les alarmes.pdf
Barbare, non, sans toi | Gluck, Christoph Willibald von | Alceste | Check (Admète) | Barbare, non, sans toi.pdf
Crudele, senza te | Gluck, Christoph Willibald von | Alceste | Check (Admeto) | Crudele, senza te.pdf
Pel Dio, pe' Numi tuoi | Gluck, Christoph Willibald von | Alceste | Check (Admeto) | Pel Dio, pe' Numi tuoi.pdf
Perchè nutrir terror | Gluck, Christoph Willibald von | Alceste | Check (Admeto) | Perchè nutrir terror.pdf
O più tremar non voglio | Gluck, Christoph Willibald von | Demofoonte | Check (Matusio) | O più tremar non voglio.pdf
Il suo leggiadro viso | Gluck, Christoph Willibald von | Demofoonte | Check (Cherinto) | Il suo leggiadro viso.pdf
Vuoi ch'io m'uccida | Gluck, Christoph Willibald von | Demofoonte | Check (Cherinto) | Vuoi ch'io m'uccida.pdf
Per lei fra l'armi | Gluck, Christoph Willibald von | Demofoonte | Check (Demofoonte) | Per lei fra l'armi.pdf
Gemo in un punto e fremo | Gluck, Christoph Willibald von | Demofoonte | Check (Timante) | Gemo in un punto e fremo.pdf
Sperai vicino il lido | Gluck, Christoph Willibald von | Demofoonte | Check (Timante) | Sperai vicino il lido.pdf
Non curo l'affetto | Gluck, Christoph Willibald von | Demofoonte | Check (Creusa) | Non curo l'affetto.pdf
In te spero, sposo amato | Gluck, Christoph Willibald von | Demofoonte | Check (Dircea) | In te spero, sposo amato.pdf
Padre perdona | Gluck, Christoph Willibald von | Demofoonte | Check (Dircea) | Padre perdona.pdf
Du spottest meiner, erbärmlicher Tropf | Gluck, Christoph Willibald von | Der betrogene Kadi | Check (Der Kadi) | Du spottest meiner, erbärmlicher Tropf.pdf
O Tag, so wonniglich | Gluck, Christoph Willibald von | Der betrogene Kadi | Check (Der Kadi) | O Tag, so wonniglich.pdf
Will mein Weib zu Hause brummen | Gluck, Christoph Willibald von | Der betrogene Kadi | Check (Omar) | Will mein Weib zu Hause brummen.pdf
Ach, wie ist doch zu bedauern | Gluck, Christoph Willibald von | Der betrogene Kadi | Check (Fatime) | Ach, wie ist doch zu bedauern.pdf
Mein Männchen, mein Herzchen | Gluck, Christoph Willibald von | Der betrogene Kadi | Check (Fatime) | Mein Männchen, mein Herzchen.pdf
Komm, mein süsser Mann | Gluck, Christoph Willibald von | Der betrogene Kadi | Check (Omega) | Komm, mein süsser Mann.pdf
Lebe wohl, der Spass ist aus | Gluck, Christoph Willibald von | Der betrogene Kadi | Check (Omega) | Lebe wohl, der Spass ist aus.pdf
Göttin der Liebe, der ich mein Herz geweiht | Gluck, Christoph Willibald von | Der betrogene Kadi | Check (Zelmire) | Göttin der Liebe, der ich mein Herz geweiht.pdf
Deinen Worten weicht das Bangen | Gluck, Christoph Willibald von | Der betrogene Kadi | Check (Nuradin) | Deinen Worten weicht das Bangen.pdf
Rien dans la nature | Gluck, Christoph Willibald von | Écho et Narcisse | Soprano/女高音 | Rien dans la nature.pdf
Al mio fedel dirai | Gluck, Christoph Willibald von | Il re pastore | Check (Tamiris) | Al mio fedel dirai.pdf
Au faite des grandeurs | Gluck, Christoph Willibald von | Iphigénie en Aulide | Check (Agamemnon) | Au faite des grandeurs.pdf
Brillant auteur de la lumière! | Gluck, Christoph Willibald von | Iphigénie en Aulide | Check (Agamemnon) | Brillant auteur de la lumière!.pdf
O toi, l'objet le plus aimable | Gluck, Christoph Willibald von | Iphigénie en Aulide | Check (Agamemnon) | O toi, l'objet le plus aimable.pdf
Peuvents-ils ordonner | Gluck, Christoph Willibald von | Iphigénie en Aulide | Check (Calchas) | Peuvents-ils ordonner.pdf
Calchas, d'un trait mortel blessé | Gluck, Christoph Willibald von | Iphigénie en Aulide | Check (Achille) | Calchas, d'un trait mortel blessé.pdf
Cours, et dis-lui: qu'elle n'a rien à craindre | Gluck, Christoph Willibald von | Iphigénie en Aulide | Check (Achille) | Cours, et dis-lui qu'elle n'a rien à craindre.pdf
Cruelle, non, jamais votre insensible | Gluck, Christoph Willibald von | Iphigénie en Aulide | Check (Achille) | Cruelle, non, jamais votre insensible.pdf
Armez-vous d'un noble courage | Gluck, Christoph Willibald von | Iphigénie en Aulide | Check (Clytemnestra) | Armez-vous d'un noble courage.pdf
Jupiter, lance ta foudre | Gluck, Christoph Willibald von | Iphigénie en Aulide | Check (Clytemnestra) | Jupiter, lance ta foudre.pdf
Par son père cruel à la mort condamnée | Gluck, Christoph Willibald von | Iphigénie en Aulide | Check (Clytemnestra) | Par son père cruel à la mort condamnée.pdf
Que j'aime à voir ces hommage flatteurs | Gluck, Christoph Willibald von | Iphigénie en Aulide | Check (Clytemnestra) | Que j'aime à voir ces hommage flatteurs.pdf
Son front est couronne des mains de la victoire | Gluck, Christoph Willibald von | Iphigénie en Aulide | Check (Eine Griechin) | Son front est couronne des mains de la victoire.pdf
Adieu, conservez dans votre âme | Gluck, Christoph Willibald von | Iphigénie en Aulide | Check (Iphigénie) | Adieu, conservez dans votre âme.pdf
Hélas! mon coeur sensible et tendre | Gluck, Christoph Willibald von | Iphigénie en Aulide | Check (Iphigénie) | Hélas! mon coeur sensible et tendre.pdf
Il faut de mon destin | Gluck, Christoph Willibald von | Iphigénie en Aulide | Check (Iphigénie) | Il faut de mon destin.pdf
Iphigénie, hélas! vous a trop fait connaitre | Gluck, Christoph Willibald von | Iphigénie en Aulide | Check (Iphigénie) | Iphigénie, hélas! vous a trop fait connaitre.pdf
Les voeux, dont ce peuple m'honore | Gluck, Christoph Willibald von | Iphigénie en Aulide | Check (Iphigénie) | Les voeux, dont ce peuple m'honore.pdf
Par la crainte et par l'espérance | Gluck, Christoph Willibald von | Iphigénie en Aulide | Check (Iphigénie) | Par la crainte et par l'espérance.pdf
Vivez, vivez pour Oreste, mon frère | Gluck, Christoph Willibald von | Iphigénie en Aulide | Check (Iphigénie) | Vivez, vivez pour Oreste, mon frère.pdf
Heureux guerriers, volez a la victoire | Gluck, Christoph Willibald von | Iphigénie en Aulide | Soprano/女高音 | Heureux guerriers, volez a la victoire.pdf
Dans cet objet touchant | Gluck, Christoph Willibald von | Iphigénie en Tauride | Check (Oreste) | Dans cet objet touchant.pdf
Dieux qui me poursuivez! | Gluck, Christoph Willibald von | Iphigénie en Tauride | Check (Oreste) | Dieux qui me poursuivez!.pdf
Le calme rentre dans mon coeur | Gluck, Christoph Willibald von | Iphigénie en Tauride | Check (Oreste) | Le calme rentre dans mon coeur.pdf
Que ces regrets touchants pour mon coeur ont des charmes | Gluck, Christoph Willibald von | Iphigénie en Tauride | Check (Oreste) | Que ces regrets touchants pour mon coeur ont des charmes.pdf
Quoi! toujours à mes voeux vous êtes inflexible? | Gluck, Christoph Willibald von | Iphigénie en Tauride | Check (Oreste) | Quoi! toujours à mes voeux vous êtes inflexible.pdf
De noirs pressentiments, mon âme intimidée | Gluck, Christoph Willibald von | Iphigénie en Tauride | Check (Thoas) | De noirs pressentiments, mon âme intimidée.pdf
De tes forfaits la trame est découverte | Gluck, Christoph Willibald von | Iphigénie en Tauride | Check (Thoas) | De tes forfaits la trame est découverte.pdf
Ah! laissons-là ce souvenir funeste | Gluck, Christoph Willibald von | Iphigénie en Tauride | Check (Iphigénie) | Ah! laissons-là ce souvenir funeste.pdf
D'une image, hélas! trop chérie | Gluck, Christoph Willibald von | Iphigénie en Tauride | Check (Iphigénie) | D'une image, hélas! trop chérie.pdf
Je t'implore et je tremble | Gluck, Christoph Willibald von | Iphigénie en Tauride | Check (Iphigénie) | Je t'implore et je tremble.pdf
O malheureuse Iphigénie | Gluck, Christoph Willibald von | Iphigénie en Tauride | Check (Iphigénie) | O malheureuse Iphigénie.pdf
Ô toi qui, prolongeas mes jours | Gluck, Christoph Willibald von | Iphigénie en Tauride | Check (Iphigénie) | Ô toi qui, prolongeas mes jours.pdf
Tremblez! on sait tout le mystère | Gluck, Christoph Willibald von | Iphigénie en Tauride | Check (Prêtresse) | Tremblez! on sait tout le mystère.pdf
Ah! mon ami, j'implore ta pitié! | Gluck, Christoph Willibald von | Iphigénie en Tauride | Check (Pylade) | Ah! mon ami, j'implore ta pitié!.pdf
Divinité des grandes âmes! | Gluck, Christoph Willibald von | Iphigénie en Tauride | Check (Pylade) | Divinité des grandes âmes!.pdf
Unis dès la plus tendre enfance | Gluck, Christoph Willibald von | Iphigénie en Tauride | Check (Pylade) | Unis dès la plus tendre enfance.pdf
Mahomet, notre grand prophète | Gluck, Christoph Willibald von | La rencontre imprévue | Check (Le Chef de la Caravane) | Mahomet, notre grand prophète.pdf
C'est un torrent impétueux | Gluck, Christoph Willibald von | La rencontre imprévue | Check (Vertigo) | C'est un torrent impétueux.pdf
D'un céleste transport mon âme est agitée | Gluck, Christoph Willibald von | La rencontre imprévue | Check (Vertigo) | D'un céleste transport mon âme est agitée.pdf
Des combats J'ai peint l'horreur | Gluck, Christoph Willibald von | La rencontre imprévue | Check (Vertigo) | Des combats J'ai peint l'horreur.pdf
Un ruisselet, Bien clair, bien net | Gluck, Christoph Willibald von | La rencontre imprévue | Check (Vertigo) | Un ruisselet, Bien clair, bien net.pdf
Castagno, castagna, Pista fanache | Gluck, Christoph Willibald von | La rencontre imprévue | Check (Le Calender) | Castagno, castagna, Pista fanache.pdf
D'une telle lâcheté | Gluck, Christoph Willibald von | La rencontre imprévue | Check (Le Calender) | D'une telle lâcheté.pdf
Il fait entendre sa sonnette | Gluck, Christoph Willibald von | La rencontre imprévue | Check (Le Calender) | Il fait entendre sa sonnette.pdf
Les homme pieusement | Gluck, Christoph Willibald von | La rencontre imprévue | Check (Le Calender) | Les homme pieusement.pdf
Bel inconnu qu'ici l'amour amène | Gluck, Christoph Willibald von | La rencontre imprévue | Check (Balkis) | Bel inconnu qu'ici l'amour amène.pdf
Sans votre brusque retraite | Gluck, Christoph Willibald von | La rencontre imprévue | Check (Balkis) | Sans votre brusque retraite.pdf
Venez, venez, troupe brillante | Gluck, Christoph Willibald von | La rencontre imprévue | Check (Balkis) | Venez, venez, troupe brillante.pdf
J'ai perdu mon doux ramage | Gluck, Christoph Willibald von | La rencontre imprévue | Check (Amine) | J'ai perdu mon doux ramage.pdf
A ma maîtresse J'avais promis, Seigneur | Gluck, Christoph Willibald von | La rencontre imprévue | Check (Dardanée) | A ma maîtresse J'avais promis, Seigneur.pdf
J'ai fait un rève des plus doux | Gluck, Christoph Willibald von | La rencontre imprévue | Check (Dardanée) | J'ai fait un rève des plus doux.pdf
Ah! qu'il est doux de se revoir | Gluck, Christoph Willibald von | La rencontre imprévue | Check (Rézia) | Ah! qu'il est doux de se revoir.pdf
Je sais que l'amoureux flambeau | Gluck, Christoph Willibald von | La rencontre imprévue | Check (Rézia) | Je sais que l'amoureux flambeau.pdf
Maître des coeurs, achève ton ouvrage | Gluck, Christoph Willibald von | La rencontre imprévue | Check (Rézia) | Maître des coeurs, achève ton ouvrage.pdf
Je chérirai jusqu'au trépas | Gluck, Christoph Willibald von | La rencontre imprévue | Check (Ali) | Je chérirai jusqu'au trépas.pdf
Tout ce que j'aime est au tombeau | Gluck, Christoph Willibald von | La rencontre imprévue | Check (Ali) | Tout ce que j'aime est au tombeau.pdf
Vous ressemblez à la rose naissante | Gluck, Christoph Willibald von | La rencontre imprévue | Check (Ali) | Vous ressemblez à la rose naissante.pdf
Heureux l'amant qui se dépètre De Cupidon | Gluck, Christoph Willibald von | La rencontre imprévue | Check (Osmin) | Heureux l'amant qui se dépètre De Cupidon.pdf
Ferma, crudele | Gluck, Christoph Willibald von | Le cinesi | Check (Lisinga) | Ferma, crudele.pdf
Ad un riso | Gluck, Christoph Willibald von | Le cinesi | Check (Tangia) | Ad un riso.pdf
Nume offensi | Gluck, Christoph Willibald von | Le feste d'Apollo | Check (Aristeo) | Nume offensi.pdf
Addio, addio, o miei sospiri | Gluck, Christoph Willibald von | Orfeo ed Euridice | Mezzo-soprano/次女高音 | Addio, addio, o miei sospiri.pdf
Cerco il mio ben cosi | Gluck, Christoph Willibald von | Orfeo ed Euridice | Mezzo-soprano/次女高音 | Cerco il mio ben cosi.pdf
Che farò senza Euridice | Gluck, Christoph Willibald von | Orfeo ed Euridice | Mezzo-soprano/次女高音 | Che farò senza Euridice.pdf
Che puro ciel | Gluck, Christoph Willibald von | Orfeo ed Euridice | Mezzo-soprano/次女高音 | Che puro ciel.pdf
Chiamo il mio ben cosi | Gluck, Christoph Willibald von | Orfeo ed Euridice | Mezzo-soprano/次女高音 | Chiamo il mio ben cosi.pdf
Deh placatevi con me | Gluck, Christoph Willibald von | Orfeo ed Euridice | Mezzo-soprano/次女高音 | Deh placatevi con me.pdf
Men tiranne voi sareste | Gluck, Christoph Willibald von | Orfeo ed Euridice | Mezzo-soprano/次女高音 | Men tiranne voi sareste.pdf
Mille pene | Gluck, Christoph Willibald von | Orfeo ed Euridice | Mezzo-soprano/次女高音 | Mille pene.pdf
Piango il mio ben cosi | Gluck, Christoph Willibald von | Orfeo ed Euridice | Mezzo-soprano/次女高音 | Piango il mio ben cosi.pdf
Dalla cetra tua | Gluck, Christoph Willibald von | Orfeo ed Euridice | Soprano/女高音 | Dalla cetra tua.pdf
Gli sguardi trattieni Amor | Gluck, Christoph Willibald von | Orfeo ed Euridice | Soprano/女高音 | Gli sguardi trattieni Amor.pdf
Che fiero momento | Gluck, Christoph Willibald von | Orfeo ed Euridice | Soprano/女高音 | Che fiero momento.pdf
È quest'asilo ameno e grato | Gluck, Christoph Willibald von | Orfeo ed Euridice | Soprano/女高音 | È quest'asilo ameno e grato.pdf
Amour, viens rendre à mon âme | Gluck, Christoph Willibald von | Orphée et Euridice | Check (Orphée) | Amour, viens rendre à mon âme.pdf
J'ai perdu mon Eurydice | Gluck, Christoph Willibald von | Orphée et Euridice | Check (Orphée) | J'ai perdu mon Eurydice.pdf
O cher trésor d'amour | Gluck, Christoph Willibald von | Orphée et Euridice | Check (Orphée) | O cher trésor d'amour.pdf
Quel nouveau ciel pare ces lieux? | Gluck, Christoph Willibald von | Orphée et Euridice | Check (Orphée) | Quel nouveau ciel pare ces lieux.pdf
Fortune ennemie! | Gluck, Christoph Willibald von | Orphée et Euridice | Check (Eurydice) | Fortune ennemie!.pdf
Si les doux accords de ta lyre | Gluck, Christoph Willibald von | Orphée et Euridice | Check (L'amour) | Si les doux accords de ta lyre.pdf
Soumis au silence | Gluck, Christoph Willibald von | Orphée et Euridice | Check (L'amour) | Soumis au silence.pdf
Cet asile aimable et tranquille | Gluck, Christoph Willibald von | Orphée et Euridice | Check (Une ombre heureuse) | Cet asile aimable et tranquille.pdf
Nell'idea ch'ei volge in mente | Gluck, Christoph Willibald von | Paride ed Elena | Soprano/女高音 | Nell'idea ch'ei volge in mente.pdf
Donzelle semplici, no non credete a quelle lagrime | Gluck, Christoph Willibald von | Paride ed Elena | Soprano/女高音 | Donzelle semplici, no non credete a quelle lagrime.pdf
Lo potrò! Ma fra tanto | Gluck, Christoph Willibald von | Paride ed Elena | Soprano/女高音 | Lo potrò! Ma fra tanto.pdf
Forse più d'una beltà | Gluck, Christoph Willibald von | Paride ed Elena | Check (Helene) | Forse più d'una beltà.pdf
T'inganni, il tuo destino | Gluck, Christoph Willibald von | Paride ed Elena | Check (Pallas) | T'inganni, il tuo destino.pdf
Dall'aurea sua stella colombe amorose | Gluck, Christoph Willibald von | Paride ed Elena | Check (Paris) | Dall'aurea sua stella colombe amorose.pdf
Di te scordarmi e vivere! | Gluck, Christoph Willibald von | Paride ed Elena | Check (Paris) | Di te scordarmi e vivere!.pdf
Le belle imagini d'un dolce amore | Gluck, Christoph Willibald von | Paride ed Elena | Check (Paris) | Le belle imagini d'un dolce amore.pdf
Oh del mio dolce ardor | Gluck, Christoph Willibald von | Paride ed Elena | Check (Paris) | Oh del mio dolce ardor.pdf
Quegli occhi belli | Gluck, Christoph Willibald von | Paride ed Elena | Check (Paris) | Quegli occhi belli.pdf
Spiagge amate, ove talora | Gluck, Christoph Willibald von | Paride ed Elena | Check (Paris) | Spiagge amate, ove talora.pdf
Fuggi dagl'occhi miei | Gluck, Christoph Willibald von | Semiramide riconosciuta | Check (Semiramide) | Fuggi dagl'occhi miei.pdf
Oscura il sol le stelle | Gluck, Christoph Willibald von | Semiramide riconosciuta | Check (Semiramide) | Oscura il sol le stelle.pdf
Tradita sprezzata che piango | Gluck, Christoph Willibald von | Semiramide riconosciuta | Check (Semiramide) | Tradita sprezzata che piango.pdf
Vieni che poi sereno | Gluck, Christoph Willibald von | Semiramide riconosciuta | Check (Sibari) | Vieni che poi sereno.pdf
Voi che le mie vivende | Gluck, Christoph Willibald von | Semiramide riconosciuta | Check (Scitalce) | Voi che le mie vivende.pdf
D'un genio che m'accende | Gluck, Christoph Willibald von | Semiramide riconosciuta | Check (Tamiris) | D'un genio che m'accende.pdf
Padre tu non m'ascolti se per entro | Gluck, Christoph Willibald von | Telemaco, ossia L'isola di Circe | Check (Telemaco) | Padre tu non m'ascolti se per entro.pdf
Parmi veder ancor ah non turbi | Gluck, Christoph Willibald von | Telemaco, ossia L'isola di Circe | Check (Telemaco) | Parmi veder ancor ah non turbi.pdf
